R 1000 1000
S		  			./textures/barrel.xpm	 	   	 		
NO		 	   ./textures/north.xpm
SO  ./textures/south.xpm    
WE  ./textures/west.xpm 
EA  ./textures/east.xpm 
F   225, 0	, 255
C  100  , 	0	,  1

11111111111111111	1            
	10010E0001000111
11111000000111000021          
10000011111100111111
1111111111111111

1111111111111111             
1001000001000111
1000000111000021          
1000001111110011
1111111111111111