R 1000 1000
S		  			./textures/barrel.xpm	 	   	 		
NO		 	   ./textures/north.xpm
SO  ./textures/south.xpm    
WE  ./textures/west.xpm 
EA  ./textures/east.xpm 
F   225, 0	, 255
C  100  , 	0	,  1

1111111111111111             
10010E0000100011
1000000111000021          
1000001111110011
1201111111110111
1000000000000001
1010101001010101        
1201111001111111
1100000000000011    
11000000000211
112121002121211      
1111111001111111
1111111001111111
1111111100111111         
111 100001111111
111 1111001111111     
10111110011111
10111110011211
11111110011111
11111110011111                                
11111110011111
11111110011111
1 111111111111