R 1000 1000
S		  			./textures/barrel.xpm	 	   	 		
NO		 	   ./textures/north.xpm
SO  ./textures/south.xpm    
WE  ./textures/west.xpm 
EA  ./textures/east.xpm 
F   225, 0	, 255
C  100  , 	0	,  1

1111111111111111
1000000000010001
1000000111000021
1000001111111001
1201111111110111
1000000000000001
1010101001010101
1201111001111111          1
1100000000000011         101
120000000000N001          1
1100000000000001111111
1200000000000021 
1121212002121211
1111111001111111
1100000000000011
1111111001111111
1111111001111111
1111111001111111
1111111001111111
1111111001111111
1111111001111111
11111110011111 1
11111110011111
11111110011111
11111110011111
11111110011111
11111111111111
11111111111111