R 1000 1000
S		  			./textures/pillar.xpm	 	   	 		
NO		 	   ./textures/north.xpm
SO  ./textures/south.xpm    
WE  ./textures/west.xpm 
EA  ./textures/east.xpm 
F   225, 0	, 255
C  100  , 	0	,  1

11111111111111111  			   
10011E0001000111211
11111010000111001021          
11000000002000111111
1111111111111111
					
1111111111111111             
1001000001000111
1000000111000021          
1000001111110011
1111111111111111