R 1000 1000
SO				  ./textures/south.xpm    
S 			  			./textures/pillar.xpm	 	   	 		
NO		 	   ./textures/north.xpm
WE  ./textures/west.xpm 
EA  ./textures/east.xpm 
F  250, 0	, 254
C  100  , 	0	,  55

1111111111111111
100110001E001111
1111100000011101          
1100002220000111
1111111011111111
1111111011111111
1001000001000111
1000000111000021
1000001111110011
11111111 1111111
1111111111111111



